00000000000000000000
00000000000000000000
0000000ddddddd000000
00000dddddddddd00000
0000dddd00000ddd0000
000ddd000000000dd000
00ddd0000000000dd000
00dd00000000000ddd00
00dd00000000000ddd00
00dd00000000000ddd00
000dd000000000dd0000
000dddd0000000dd0000
0000dddddd00ddd00000
000000ddddddddd00000
00000000000000000000
00000000000000000000
00000000000000000000
00000000000000000000
00000000000000000000
00000000000000000000
