10000000000000211111
00211111111110000001
02110000000000022001
02100011111001011200
00001122221101001120
00011200002201000120
01000000000001100120
01000000100000010100
01100111100021000100
02111122000211000101
00220000002110001101
20000001002120011001
10000011002120022012
10010022001120000000
10010000001200000110
10210000001112000010
10021000000011110010
20001111010000000010
10000000011100022110
11112220000000000000
