MMMMMMMMMMMMMMMMKKMM
MKKMMMMMMJJJJMMMMKKM
MMMMMMJJyJMMJyJMMMMM
KMMJJJJMMMMMMMMJJMMM
KMMJMMMMMMMMMMMMJJJM
KKMJJJMMMMMMMMMMMMJM
MKMJMJJJMMMMMMJJJJJM
MMMJMMMJJJMMJyJMMMJM
MMMJMKMMMJJJMMMMMMJM
MMMJMMMMKMJMMMMMMMJM
MMyJMLMMMMJMMMMMMMJM
yyyJMLMMLMJMMMMMMMJM
yyyJJMLLMMJMMMMMMJJy
MyyyJJJMMMJMMMJJyJyy
MyyyyyyJJMJMJyJyyyyy
MMMyyyyyJJJJyyyyyyMM
MKMMMMyyyyyyyyyMMMMM
MKKKMMMMyyyyyMMMMKKK
MMKKKMMMMMMMMMMKKKMM
MMMMMMMMMMMMMMMMMMMM
