00200001110000000000
022000000000111AA000
020000BB0000000A0A00
200A1000BBBBB00AA000
200AAA00000BB0AAA000
0001AA000BBB0AA00000
0001A00000000000BB00
0001A10000B0000BB000
0000AAA000BB00000000
0BB000000BBB000AA000
0B10000BBB10000AA002
0B11000BBB110000A022
0B1110000BB000AAA020
0BBBBB0000BB0AA00020
00000B0020BB00000000
00000B0200B000220000
002000000B0002001100
00222000000000001000
00022000222220000000
00000000000000000000
