00000000000000000000
00011110000000111110
00000011100011100000
00000001100100000000
01100001000110000000
00110000000011000000
00010000001111100000
00010000000000000000
00110000000000000000
00100000100000000000
00100000111111110000
00011000000000001100
00000100000000000100
00000011000011001100
00000000000010111000
00001000000011000000
00000111000111000000
00000001111100000000
00000000000000000000
00000000000000000000
