00000000000000000000
00000000000000000000
00000000000000000000
00cccc00000000cccc00
0c0000000000000000c0
00000000000000000000
000ccc00000000ccc000
000ccc00000000ccc000
000ccc00000000ccc000
00000000000000000000
000000000cc000000000
000000000cc000000000
00000000000000000000
000ccc00000000ccc000
000ccc00000000ccc000
0000ccc000000ccc0000
0000cccccccccccc0000
00000cccccccccc00000
00000000000000000000
00000000000000000000
