00000000AAAAAAAA0000
0000000AA0000000AA00
000000AA000000H00A00
000000A00000000H0AA0
000000A00000000000A0
000000A00000AAA00AA0
000000A0000AA0AAAA00
000000AA000A0000AAk0
000000AA000A000000k0
000AAAA000AA000000k0
000A00000AA000000000
00A00000AAAAAAA00000
00A00000000000AA0000
0A0A00000000000AA000
000000000000000AA000
0000AAAAAAAA00AAA000
00AAA000000A0000AAA0
00A000000000000000A0
00A000000000000000A0
00000000000000000000
