43331111113311111338
00000000000000001117
00000000000000000017
11111333333333338017
50000000000700707017
50011111110710707007
50100000010710707007
10001111000710707007
10000000000710007007
10433333800711000007
10500000700701100007
10500070700000000007
10500070700700004337
10500070700700705007
10500070704900705007
50633390705000705007
50111100733333335007
50100000000000000000
50000000010000001000
63333333311111111339
