00000000000000000000
0000cc00cccccccc0000
00cccccc0000000ccccc
00c0000000000c00000c
0cc0000000cc0000000c
0c000000ccc00000000c
cc00000cc0000cc0000c
c00000cc00000c0000cc
c00000c000000cccccc0
c00000cc000000000000
c000000cc00000000000
cc000000ccc000000000
0ccc0000000cccccc000
0000000000000000c000
00c0cc000000000cc000
0c000ccccc0cccc00000
0c00000000cc00000000
0cc000000cc000000000
00ccc0ccc0000ccccccc
0000ccc0000000000000
